#####
#   #
# O #
#   #
#PX #
#   #
#####